+--------------++--------------+                
|            ##||              |                
|     #X#      ||              |                
|     ###      ||              |                
|              ||              |                
|      #       ||              |                
+--------------++--------------+ 
+--------------++--------------+                
|      #       ||             A|                
|              ||##############|                
|K             ||     Y        |                
|              ||    ###       |                
|              ||              |                
+--------------++--------------+ 