+--------------++--------------++--------------+
|             X||              ||              |
|              ||              ||              |
|             K||              ||              |
|##############||##########    ||##            |
|##############||##########    ||##            |
+--------------++--------------++--------------+
+--------------++--------------+                
|              ||              |                
|              ||              |                
|              || ###          |                
|  ##          || ###          |                
|  ##          || ###          |                
+--------------++--------------+ 